11111111111
1P000000001
10000000001
10000C00001
10000000001
100000000E1
11111111111
