111111111111111111111111111
1000000000000000000000000C1
100000000000000001111001111
100000T0000000000100T00T0T1
1T0000000000000001T00000001
1C00000000000000010000T0001
1T0000000000000001T0000CT01
100000T000000000010C1111101
1000000000000000T1111P00001
1000000000000000000C1E00001
111111111111111111111111111
