11111111111111111111111
100111111111111111110C1
10011111111111111111001
10011111111111111111111
10010000000000000000001
1P000000000001111111111
10010000000000000000001
10011111111111111111001
10011111111111111111001
10E111111111111111110C1
11111111111111111111111
