11111111111111111111
1P1111111E1111000001
1111C111111110000001
11111111111100000001
11111110111000000010
11111111111111111111
