11111111111111111111111111111111111111111111111111111
1P000000000000000000000000000000000000000000000000001
10000000000000000000000000000000000000000000000000001
100000000000000000000000000000000000000000000C0000001
10000011111110000000000000000000000000000000000000001
10000011111110000000000000000000000000000000000000001
10000011111110000000000000000000000000000000000000001
10000011111110000000000000000000000000000000000000001
10000000000000000000000000000000000000000000000000001
10000000000000000000000000000000000000000000000000001
100000000000000000C0000000000000000000000000000000001
10000000000000000000000000000000000000000000000000001
10000000000000000000000000000000000000000000000000001
10000000000000000000000000000000000000000000000000001
10000000000000000000000000000000000000000000000000001
10000000000000000000000000000000000000000000000000001
10000000000000000000000000000000000000000000000000001
10000000000000000000000000000000000000000000000000001
10000000000000000000000000000000000000000000000000001
10000000000000000000000000000000000000000000000000001
10000000000000000000000000000000000000000000000000001
10000000000000000000000000000000000000000000000000001
10000000000000C00000000000000000000000000000000000001
10000000000000000000000000000000000000000000000000001
10000000000000000000000000000000000000000000000000001
10000000000000000000000000000000000000000000000000001
10000000000000000000000000000000000000000000000000001
10000000000000000000000000000000000000000000000000001
10000000000000000000000000000000000000000000000000001
10000000000000000000000000000000000000000000000000001
100000000000000000000000000000000000000000000000000E1
11111111111111111111111111111111111111111111111111111
